+++++++++++++++++++++                           
+                                               
+       + + S++     +                           
++ ++++++++++  ++++ +                           
 + +              + +                           
 + +              + +                           
 + +              + ++++++++++++++++++++++++++++
 + +              +                            +
 + +              ++++++++++++++++++++++++++++ +
 + +                                         + +
 + +++++++++++++++++++++++++++++++++++++++++++ +
 +                                             +
 +++++++++++++++++++++++++++++++++++++++++++++++
